**X*****X*
X*XXX*X***
X*XX**XXX*
**X**XX*X*
*XX*XX**X*
*X**X**XX*
***XXX**X*
XXXX***XX*
***X*X**X*
*X***XX***