**XXXX***X*X********XX*******X********X*X***X***X***X***XX****X***X**X*XX*****XX*X*X*******X****X***
X**XX**X***X*XX*XX*XX**X*XX*XX*XXXX*X*X*X*X***X*X*X*X*X*X**XX***X*XX*X****X*X****X*X*X*XXXXX*X*XX*X*
XX**XXXXXX***X**X***XX*X**XXX**X*X**X*X***XX*XX***X*X*X***XXXX*XX*XX***X*XX*XXXX*X***X*****X*X*X**X*
*XX*****XX*XXX*XXXX**X*XX*X***XX*X*XX*XXX*XX**XXXXXXX*XX*XX****X***XX*XX*XX**X*X*XXX*XXXX*XX*X*X*XX*
**XXXXX**XXX***X*XXX*XXX**X*XXX**X**X***X**XX***X******XXXXXX*XXXX**XXXX**XX*X***XX**X*X**XX*X*X*X**
X*****XX*X***XXX***X**X**XX*X***XXX*XXX*XX**XX*XX*XXXXXX***XX****XX***X**XX**X*XXX**XX*X*XX**X***X*X
XX*XXXXX***XXX*XXX*XX*XX*X**X*XXXX**X*X**XX*X**X**X*XX***X**X*XX**XXX*XXXX**XX**X**XX**X*X**XXXXXX**
*X*****XXXXXX******XX*X**X*XX****X*XX*XX**X*X*XX*XX*X**XXXX*XXX**XX*****X**XXXX*XX*XXX*X***XX***X**X
***X*X******XXX*X*XX**XX*X**XX*X*X*X**XXX*X*X**X*X**X*XX**X**XXX**XXXXX*XX***X***X***X*XXXXXX*X*X*XX
XXXXXX*XXXX**X**X**X*XX**X*XX**XXX*XX***X*XXXX*X***XX*X**XXX*X*XX*X***X*X**X*XXX*X*X**********X*X***
*****X*X**XX*XX*XX*X*XXX******XXX**X**X*X**XX**X*XXX**X*XX***X******X*X*XX*X**XX*XXXX*XXXXXXX*X*XXX*
X*XX***XX*X**X**X**X***XXXXXX*XX**XX*XX*XX**X*XX**X**XX*XXX*XXXXXXXXX*X**X*XX*X*****X**X***XX*XXX***
***XXXXXX***XXX*X*XXXX*X****X**X*XXXXX***XX*X****XX*XX***X**X*****X***XX*X*XX*XXXXX*XXXX*X*X***X**X*
*X*X**X***XXX***X***X**X*XX*X*XX*X*****X*X**X*XXXX**X**X*X*XXXX*X*X*XXXX*X**X***X*X****X*X*X*XXX*XX*
*X*XX*X*XXX*XX*XX*XXX*XX*XX*XXX**X*XX*XX*X*XX***X**XXX*X*X*X****X***X**X*XX*XXX*X*XXXX***X*XXX***XX*
*X**X***X****XXX***X**XX*X**X***XXXXX**X*X**XXX*X*XX*XXX*X*X*X*XXXXXX*XX*X**X***X*X*XXXXXX**XXX*XX**
*XX*X*XXX*XX***XXX*X*XX**X*XXX*XX***XX*X*XX*X*X*X**X**X**X*XXX*X*XX******X*XX*XXX********XX**X**XXX*
*X**X**X**XXX*XX***X**X*XX*X***X**X*X**X*X**X***XX*XX***XX*X***X*X**XXXXXXXX**X*X*XXX*XX**XX*XX**X**
XX*XXX*XX*X****XX*XXX*X*XX***XXX*XX*X*XX*X*XXX*XX**XXX*XXX*XX*XX***XX********XX*X**XX*XX*XXX*XXX*X*X
***X*X*X**XXXX*XX**X**X**XXXXXX**X****X**X**X***X*XX***XX**X***X*XXX**XX*XXXXXX*XX**X**X*X***X***X*X
X*XX*X*XX***XX**X*XX*XXX***X****XXXXXXX*XXX*XXX*X**X*X*X**XX*X*X**XX*XX**X*XX*X**XX*XX*XXX*XXXX*XX**
**X**X*X**X**XX*X*XX**XX*X*XXX*XXX***XX***X**X**XX*X*X*X*XXXXX*XX**XXX**XX**X***XXX**X**XX**X*X*XXX*
*XX*XX*XX*XX*X**X**XX**XXX**X**X***X**XXX*XX*XX**X*XXX*X**X*****XX*****XXXX*X*X***XX*XX**XX*X***X***
*X***X*X***X*XX*XX**XX***XX*XX***XXXX***X**X**XX*X***X*XX*XX*XXXXXXX*X*XX*X***X*X*****XX*X**XX*XX*XX
*XXX*X*XXX*X**X**XX**XXX****X**XXX**XXX*XXXXX**X*XXX*X*X**XX*X*****XXXXX**X*XXXXXXXX*XXX*X*XX**X**X*
**XX*X***X*XX*XX****XX*XXXXXX*XXX**XX*X*****XX*XXX***X***XX**X*XXX****X**XX*X******X**X**X**X*XXX***
X**X*XXX*XXX***XXXX**X****X*X*X***XX**XXX*X**X***XX*XXX*XX**XX***X*XX*X*XX**X*XXXX*XX*X*XXX*X*X*XX*X
XX*X***X**XXX*XX**XX***XX*X*X*XX*XXXX**X**XX*XXX*X**X****XX**XX*XXXX**X*XX*XX*X**X**XXX*X***X*X**X**
X**XXX*XX*X****X*XXXXXXX**X*X****X**XX*X*XX****X*X*XXXXX*XX*XX***X***XX*X**X**X*XXX*X***X*XXX*XX*XX*
**XXX**XX*X*XX*X**X****XX*X*XXXX*XX****X**XXX*XX*X**XX*X**X*X**X*X*X*XX***XX*XX*X*X*XX*XX***X*X***X*
*XX***XX**X*X**X*XX*X*XX****X*X**X**XX*XX***XXX**X*XX**XX*X***XXXX*X**XXXXXX*X****X**X**XXX*X*X*X*X*
*X**X**X*XXXX*XX*X**X****X*XX***XXX**X**XXX**XX*XX**X*XX**X*XXX*X**XX*X******X*XX*XX*XX***X*X*XXX***
*XX*X*XX*X****X**X*XXXXXXX*X**XXX*XX*XX***XX*X***XX*X****XX*XX****XXXXX*XXXXXX*X***X*X**X*X*X***X*XX
**X*XXX**XX*XXX*XX**XX***XXX*XX***X**XXX*XXX*X*XXX**X*XXXX***X*XX**XX***X****X*X*X*X*XX*X*X*XXX*X*X*
X*X**X**XX****X*XX*XX**X**X**X**X*X*XX*X*X*X*X*****XX*XX***XXX**XX*X**XXXX*X*XXX*XXX**X*XXX*X***X*X*
**XX*X*XXXXXX*X**X****XX*XX*XX*XX*X*X**X***X*XXXXXXX***XXX**X**XXXXX*XX**X*X**XX**XXX*X**XX*XX*XX***
*XXX***X****X*XX*XXXX**XXX**X**XX*X***XXX*XX*******XXX***X*XX*XX*****XXX***XX**XX***X*XX*X**X**XX*XX
***X*XXX*XX*X*XX***XX*XXX**XXXXX**X*X*X*X**XXXXXXX***XXX*X*X***XX*XXXX*XX*XXXX**XX*XX**X*X*XXX*X***X
*X*X*XX**X****X**X*X***X**XX*****XXXX*X*XX******XXX*XXX**XXX*XXX***XX******X*XX**X**XX*X*X*XX**X*X**
XX*X*X**XXXXXXXXXX***X*X*XXX*X*X**XX**X**XX*XX*XX*X***XX**X******X**XXXX*X*X**XX*X*XX**X*X**XX*XXX*X
***X***XXX*******XX*XX*X*XX**X*XXXX**XX*XX**X*****X*X**XX*X*X*XXXXX****XXX*X*XX****X**XX*XX*X**XX***
X*XXXXXX*X*XXXX*XX***XXX**XXXX***X**XX**X**XXXXXX*X*XXXXX*X*XXX***XXXX*X***X****XXXX*XX*****XX**X*XX
X*****X**X****X**X*X**XXX**XX**X*X*XX**XX*XX***XX*X*X*****X*X***X***XX*XX*XX*XXXX****X**XXXXXXX*X*X*
**XXX***XXXX*XXX*XXXX*X*XX**XX*X*X*X**XXX*XX*XXX**X***XXXXX*X*XXXXX*X***X*XXXXX***XXXX*XX****XX*X*X*
*XX*XX*XXX****XX***XX*X**XX**X*X*****XX***X***X**XXXXXXX****X**XX***XXX*X*****X*XXX**X****X*XX**X*X*
*X***X**X**XX**XX*XX**XX**XX*X*X*XXXXXXX*XX*XXX*XX*X***X*XXXXX*X**XXX***X*X*X*X*X***XXXXXXX*X**XX*X*
***XXX*XX*XXXXXX**X**XXXX*X**XXXXX*******X**XX**X****XXX*X**XX*X*XX*XX*XXXXXX*X*X*XXX*X***X***XXX***
X*XX****X**XX****XXX******X*XXX****XXXXXXX*XX**XX*XX**XX*XX*X**X*X*****X****X*X*X**XX***X*XXXXX*XX*X
XXX**X*XXX**XX*XXX*XXX*XXXX*X*X*XXXX*******XX*XXX*XXX**X*XX*X*XX*X*XXXXX*XX***X*XX****X*X***XX***X**
*X**XX**X**XX**X*****X**XX**X*X****X*X*XX*XX**X***X*XX*X**X*X**X*X****X***XXX*X**XXXX*X*XX*XX**X*XX*
***XX**XX*XX**XXX*XX*XX**X*XX*X*XX*XXX**XXX**XX*XXX**X*XX***XX*X*XXXX*X*X**X**XX***X**X*XX*X**XX**X*
*XXXXXXX**XX*XX*X*X**XXX*X**X****X**XXX**X**XXX**XX*XX*XX*XXX**X**X*X*XXXX*X*XXXXX*X*XX**X*X*XX**XX*
*X*******XX**X****X*XX***XX*X*XXXXX*X*XX*X*XXX**XX***X*X***X**XXX*X****XX**XXX***X*X*XXX*X*X**X*XX**
*X*XXXXXXX**XXXX*XXXX**X*XX*X*X***X*X*XX*X***XX*X**X*X***X*X*XXX**XX*X**XX**X**X*X*X**XX*XXX*XX*X**X
*X*******X*XX****X*X**XXXX**X*X*X*X*X****XXX*X**X*XXXXXXXXXX*X***XX**XX**XX***XX*X*XX**X**XX*X**X*XX
*XX*XX*XXX*XXX*X*X***XX*X**XXXX*X***XXX*XXX**X*XX**X*****XX**X*XXXXXXXXX**XX*XXX*X**XXXXX****X*XX***
*X***XXX***X***XXX*XXX**X*XXXX**XXXXX****X**XX**XX*X*XX*XX**XX*X*****XXXX*XX*XX**XX*X***X*XXXX**XX*X
*X*X**XX*XXX*X*XX***X**XX*X*X**XX**XXX*XXX*XXXX**X*X*X***X*XXX*XX*XX**X****X**X*XX**X*X*X****XX*X***
***XX**X*X***X****X***XXX***X*XXXX***X***X**X*XX*X*X*X*X*X*X*X*XX**XX*XXXX*XX*X**X*XX*X*XX*XXXX*X*XX
*XXXXXXX*XXXXXXXXXXXX*X*XXX***XX*XX*XX*X*XX*X*XX*X*X*XXX***X****XX*X***XX*****XX*X*X**X*XXXX****X*X*
*XX*XX***X*********X*****XXXXXX******X*X*X**X*X****X***XXXXXXXX****XXX**X*XXXXXX*X*X*XX*X****X*XX*X*
**X*X**X*X*XXXXXXX*XX*XX*X******X*X*XX*X*X*XX*X*XX*X*X****X*X*XXXXXX*XX*XXX****X*X***XX*XXX*XX*X**X*
X*X*X*XX*X**XX***X**X**XXX*X*XXXX*XXX**X*X*XX****XXXXXXXX*X*X*****X***X**X**XX*X*X*XXX**X***X**X*XX*
**X*X**XXX*XX**X*XX*XX**X**X**X***X***XX*X**XX*X**XXX*X***X*X*XXX*X*X*XX*X*XX**X*XXX*X*XXX*XXXXX*X**
*XX*XX***X**XX*X**X*XXXXX*XXX*XX*XX*XXX**XX*X**XX**X**X*XXX***X***X*X**X*X*XXX*X**X**X**X***XX***XX*
*X***XX*XXX**XXXX*X***XX****X**XXX**X***XX**XXXXXX***XX**XXXXXX*XXX*XX*X*XXX***XX***XXX*XXX****XXX**
*X*X**X*X*XX******XXX**X*XXXXX***XX*X*XXX**XXX***X*X*XXX***X****XX**XX*X**XX*X**XX*XX*X**XXXX*XXX**X
*X*X*XX***XXXXXXX***XX*X**XX*XX*XX**X**X**XX***X*XXX**XXXX*X*XX**X*XX**XX*X**XX*XX****XX****X*****XX
*X*X**XXX*X*****XXX**X*XX**X*X**X**XX*XX*XX**X*X***XX**X***X*X**XX*X**XX**X*XX***XXXX*XXXXX*X*XXX*X*
*X*X*XXX**X*XX*XX*XX*X**XX*X*X*XX*XXX*X**XXX*XXXXX**XX*X*XXX*X*XX**X*XXX*XX*X**X**XX****X***XXX*X***
***XXX***XX**X*******X*XX****X*X****X*X*XX*X*XX**XX*XXXX*X***XXXX*XX*X***X**X*XXX**X*X*XX*XXXX**XX*X
*X**X**X**XX*XXXXXXXXX**XXXX*X***XXXX*X******X**XX**X*X**X*X****X*XX*X*XXXX*XXX*XX*X*XXX**X****XXX**
*XXXX*XXX**X**X**X***XX******X*XXXX***XXXXXXXX*XXXX*X***XX*XX*X*X**X***X*********X*X**XX*XX*XXXXX**X
XXX***X*XX*XX*XX***X**XXXXXXXXXX****X****XX*****XX**X*XXX**X**X*X*XXXXXXXX*X*X*X*X*XX**X**X*****XX**
****XXX**X*XX*X**XXX*XX**XX***X**XXXXXXX**X*X*XXX**XX*X*X*XX*XXXX*X******XXXXXXX*XXX**XXX*XXX*X**XX*
*XXXX***XX**X*XX*XX***XX*X**XXX*XXX****XXXX*X*XX**XX**X****X**X***XXX*XX*X****XX**X**XX*X**X**XX*X**
**X***X**XX*X*X***X*X*X****XX***X***XX**X***X**X*XXX*XX*XXXXX*X*XXXX**X****XX**XX*X*XX**XX*X*XX**X*X
X*X*X*XXXX**X*XXXXX*X*X*X*XX**X*X*XXXXX***XXXX***X***X**XX**X*X*XX***XXXXXXXXX*X****X**XX**X*XX*XX**
**X*X****XX*X**X****X*XXX**X*XX*X**X*XXXXXX**XXXXX*XXXX**X*XX*X****X*X**X****X*XX*XXX*XXX*XX**X**XX*
*XX*XXXX*X**XX*XX*X*X*****XX**XXXX*X*X****XX*****X*X**XX*X**X*XXXXXXXXX***X*XX**X*****X***XXX*XXXX**
*X***X*X*X*XX**X**XXXXXXX*XXX**X*X***X*X*XXX*XXX***XX******XX*****X*XXXXX*X**XX*XXXXX*X*XXX*X**X***X
*XXX*X*X****X*XXX*XX***XX***XX***XXX*XXX**X**X*XX*XX**XXXXXXX*XXX*X**XXX**XX**X*****X*X**X****XX*XXX
**X**X*XXXXXX***X**X*X**XXX**XX*XX*X**XX*XX*XX**X*X**XX***XX**X*X*XX**X**XXX*XXXXXX*XXXX*XX*XXXX*X*X
X*XX*X*****XXXX*XX*XXXX**XXX**X****XX**X*******XX*XX*X**X*X**XX*X**XX***XX***X****X****X**X***X**X**
***X*XXX*X****X*XX**X*XX**XXX*XX*X**XX*XXXXXXX**X**XXX*XX***XX**XX*XXXXXX**X*X*X*XXXXX*XX*X*X*X*XXX*
XX*X*****XX*XXX**XX*X**XX*X*X**X*XX**X**X****XXXXX**XX**XXXXXXX***********XX*X*X*X*XX**X**X*X*X*X*X*
***XXXXXXXX**XXX****XX*XX***XX*X**XX*XX*X*XX****XXX**XX*X****X**XXXXXXXXXXX**X*X***X**XX*XX*X***X***
*XXX******XX***XXXXXX**X**X*X**XX*XX*XX***XXXXX*X*XX*X**X*XX*XX**X****X**X**XX*XX*XX*XX**XX*XXXXXX*X
***XX*XXX**XX*XX****XX***XXXX*XXX**X**XXXXX***X*X****X*XX**X**XX*X*XX*XX***XX**XX**X*X**XX**X****X**
*X*****XXX*X**X**X*XX**XXXX***X*XX*XX**XX***X*X*XX*X*X**X*XXX**XXX*XX*XXXXXX**XX**XX*XX*XX*XX*XX***X
*XXXXXXX*X*XX*X*XX****XX****XXX**X**XX****XXXXX*X**XXXX*X**XXX**X**X**X******XX**XX**XX*X**X***XXX**
**X*X****X**XXX*XXXX*XX**XXXX*XX*XX*XXXXX**XX***X*XXX***XX**XXX***XX*XX*XXXXXX**XX**XX**X*XXX*XX*XX*
X*X***X*XXX*X******X*X**XXX*******X*****XX**XX*XX*X*X*X**XX*X*XXXXXX**X*X**X***XXX*XX**XX**X***X**X*
**XXXXX***X*X*XXX*XX*X*XXX**XX*X*XXXXX*XXXXXX**X**X***XX*XX*X****X***XX*XX*X*XXXX**X**XXXX*X*X*XX***
*XX***XX*XX*****XXX**X**X**XXX*X*X***X****X***XXX*XX*XXX*X**XX*XXX*X**X*XX*X*XX***XXX*XX***X*X**XXX*
*XX*X*X***XXXXXXX***XXX*XX*X***X*XX*XXXX*XX*XXXX***X*X***X*XXX*X***X*XX*X**X****XXX****XX*XXXX*XXX**
**X*X*X*X**X******X***X**X*X*XXX**X****X**X**X*X*X*X*X*XXX*X***X*XXX*X****XXXXXXX*XXXX*X***X***XX**X
X*X*X*X*XX*X*XXXXXXXXXXX*XXX*X*XX*X*XX*XX*XX*X***X*X*X**XX*XX*XX**XXXX*XX**XX***X******XXX*XX*XX**XX
X*X*X*X*X**X**X***X***XX*XX**X**X*X*X***X**X*XXXXX*X*XX**X*X***XX**XX***XX**X*X*XXX*XXXX***X**XX*XX*
****X***X*XXX***X***X*******XXX*****X*X*XX*********X**XX*****X**XX****X**XX***X*****X****X***XX*****