****X*********
****X*********
******X*******
**************
***********X**